Awake - Asleep
Begin - End
Big - Small
Brave - Scared
Bright - Dim
Buy - Sell
Clean - Dirty
Day - Night
Far - Near
Fast - Slow
Front - Back
Top - Bottom
Full - Empty
Give - Take
Happy - Sad
Hard - Soft
Healthy - Sick
Heavy - Light
High - Low
Hot - Cold
In - Out
Left - Right
Light - Dark
Long - Short
Loud - Quiet
North - South
Open - Closed
Locked - Unlocked
Push - Pull
Sharp - Dull
Simple - Difficult
Start - Finish
Strong - Weak
Sweet - Sour
Thick - Thin
True - False
Up - Down
Wet - Dry
Wide - Narrow
Win - Lose
Young - Old
